R 1200 1000 
NO shanks.xpm
SO ayoub.xpm
WE maroc.xpm
EA hani.xpm
S eagle.xpm
F 150,200,20
C 50,80,120



    1111111111111111111111111
111100001000111110000001
1000000000000000000000001
1000000000000000000000001
1000000000000000000000001
1000000000000000000000001
1000000000000000000000001
1000000000000000000000001
1000000000000000000000001
1000000000000000000000001
1000E00000000000000000001
1000000000000000000000001
1000000000000000000000001
1000000000000000000000001
1111111111111111111111111